1111111111111
100100CJ000C1
1CH0011111I01
1P0011E000001
1111111111111