1111111111111111111111111
1000C000E00000000000000P1
1000C00000000000000000001
1000C00000000000000000001
1000C00000001000000000001
1000C00000001000000000001
1000C00000001111111111111
1000C00000000000000000001
1000C00000000000000000001
1000C00000000000000000001
1000C00000000000000000001
1000C00000000000000000001
1111110000000000000000001
1000C00000000000000000001
10000000000000000000C0001
1111111111111111111111111